================ SETTINGS ================
               files:	['./Data/Ragni/Class0/cv0_train_28.pl']
             verbose:	3
                   l:	3
                   p:	0.8
           beam_size:	100
                seed:	None
                 log:	./Logs/Ragni/Class0/cv0_rall28.log
              target:	rall28/2
   symmetry_breaking:	False
           probfoil1:	False
================= FINAL THEORY =================
rall28(A,B) :- all28(C,A), some28(C,B)
==================== SCORES ====================
            Accuracy:	 1.0
           Precision:	 1.0
              Recall:	 1.0
================== STATISTICS ==================
    Rule evaluations:	222
          Total time:	11.3543s
