================ SETTINGS ================
               files:	['./Data/Ragni/Class0/cv0_train_80.pl']
             verbose:	3
                   l:	3
                   p:	0.8
           beam_size:	100
                seed:	None
                 log:	./Logs/Ragni/Class0/cv0_rnvc80.log
              target:	rnvc80/2
   symmetry_breaking:	False
           probfoil1:	False
================= FINAL THEORY =================
rnvc80(A,B) :- some80(C,B), no80(C,A)
==================== SCORES ====================
            Accuracy:	 1.0
           Precision:	 1.0
              Recall:	 1.0
================== STATISTICS ==================
    Rule evaluations:	222
          Total time:	6.3503s
