================ SETTINGS ================
               files:	['./Data/Ragni/Class0/cv0_train_4.pl']
             verbose:	3
                   l:	3
                   p:	0.8
           beam_size:	100
                seed:	None
                 log:	./Logs/Ragni/Class0/cv0_rnvc4.log
              target:	rnvc4/2
   symmetry_breaking:	False
           probfoil1:	False
================= FINAL THEORY =================
rnvc4(A,B) :- no4(C,A), no4(B,C)
==================== SCORES ====================
            Accuracy:	 1.0
           Precision:	 1.0
              Recall:	 1.0
================== STATISTICS ==================
    Rule evaluations:	222
          Total time:	5.7035s
