================ SETTINGS ================
               files:	['./Data/Ragni/Class2/cv2_train_9.pl']
             verbose:	3
                   l:	None
                   p:	0.8
           beam_size:	100
                seed:	None
                 log:	./Logs/Ragni/Class2/cv2_rnvc9.log
              target:	rnvc9/2
   symmetry_breaking:	False
           probfoil1:	False
================= FINAL THEORY =================
rnvc9(A,B) :- some9(A,C), some9(C,B)
rnvc9(A,B) :- somenot9(B,C), some9(C,A)
==================== SCORES ====================
            Accuracy:	 1.0
           Precision:	 1.0
              Recall:	 1.0
================== STATISTICS ==================
    Rule evaluations:	530
          Total time:	21.5371s
