================ SETTINGS ================
               files:	['./Data/Ragni/Class2/cv2_train_92.pl']
             verbose:	3
                   l:	None
                   p:	0.8
           beam_size:	100
                seed:	None
                 log:	./Logs/Ragni/Class2/cv2_rsomenot92.log
              target:	rsomenot92/2
   symmetry_breaking:	False
           probfoil1:	False
================= FINAL THEORY =================
rsomenot92(A,B) :- somenot92(B,C), no92(C,A)
==================== SCORES ====================
            Accuracy:	 0.85
           Precision:	 1.0
              Recall:	 0.1
================== STATISTICS ==================
    Rule evaluations:	31807
          Total time:	502.7053s
