================ SETTINGS ================
               files:	['./Data/Ragni/Class2/cv2_train_54.pl']
             verbose:	3
                   l:	None
                   p:	0.8
           beam_size:	100
                seed:	None
                 log:	./Logs/Ragni/Class2/cv2_rnvc54.log
              target:	rnvc54/2
   symmetry_breaking:	False
           probfoil1:	False
================= FINAL THEORY =================
rnvc54(A,B) :- no54(C,A), no54(C,B)
==================== SCORES ====================
            Accuracy:	 1.0
           Precision:	 1.0
              Recall:	 1.0
================== STATISTICS ==================
    Rule evaluations:	222
          Total time:	6.4897s
