================ SETTINGS ================
               files:	['./Data/Ragni/Class2/cv2_train_57.pl']
             verbose:	3
                   l:	None
                   p:	0.8
           beam_size:	100
                seed:	None
                 log:	./Logs/Ragni/Class2/cv2_rno57.log
              target:	rno57/2
   symmetry_breaking:	False
           probfoil1:	False
================= FINAL THEORY =================
rno57(A,B) :- all57(B,C), some57(C,A)
==================== SCORES ====================
            Accuracy:	 1.0
           Precision:	 1.0
              Recall:	 1.0
================== STATISTICS ==================
    Rule evaluations:	222
          Total time:	18.6963s
