================ SETTINGS ================
               files:	['./Data/Ragni/Class6/cv6_train_52.pl']
             verbose:	3
                   l:	None
                   p:	0.8
           beam_size:	100
                seed:	None
                 log:	./Logs/Ragni/Class6/cv6_rno52.log
              target:	rno52/2
   symmetry_breaking:	False
           probfoil1:	False
================= FINAL THEORY =================
rno52(A,B) :- all52(C,B), all52(A,C)
==================== SCORES ====================
            Accuracy:	 1.0
           Precision:	 1.0
              Recall:	 1.0
================== STATISTICS ==================
    Rule evaluations:	222
          Total time:	103.4478s
