================ SETTINGS ================
               files:	['./Data/Ragni/Class6/cv6_train_68.pl']
             verbose:	3
                   l:	None
                   p:	0.8
           beam_size:	100
                seed:	None
                 log:	./Logs/Ragni/Class6/cv6_rno68.log
              target:	rno68/2
   symmetry_breaking:	False
           probfoil1:	False
================= FINAL THEORY =================
rno68(A,B) :- all68(A,C), no68(C,B)
==================== SCORES ====================
            Accuracy:	 1.0
           Precision:	 1.0
              Recall:	 1.0
================== STATISTICS ==================
    Rule evaluations:	222
          Total time:	12.4638s
