================ SETTINGS ================
               files:	['./Data/Ragni/Class3/cv3_train_9.pl']
             verbose:	3
                   l:	None
                   p:	0.8
           beam_size:	100
                seed:	None
                 log:	./Logs/Ragni/Class3/cv3_rnvc9.log
              target:	rnvc9/2
   symmetry_breaking:	False
           probfoil1:	False
================= FINAL THEORY =================
rnvc9(A,B) :- some9(C,B), some9(A,C)
rnvc9(A,B) :- some9(C,A), somenot9(B,C)
==================== SCORES ====================
            Accuracy:	 1.0
           Precision:	 1.0
              Recall:	 1.0
================== STATISTICS ==================
    Rule evaluations:	530
          Total time:	17.8773s
