================ SETTINGS ================
               files:	['./Data/Ragni/Class1/cv1_train_4.pl']
             verbose:	3
                   l:	None
                   p:	0.8
           beam_size:	100
                seed:	None
                 log:	./Logs/Ragni/Class1/cv1_rnvc4.log
              target:	rnvc4/2
   symmetry_breaking:	False
           probfoil1:	False
================= FINAL THEORY =================
rnvc4(A,B) :- no4(B,C), no4(C,A)
==================== SCORES ====================
            Accuracy:	 1.0
           Precision:	 1.0
              Recall:	 1.0
================== STATISTICS ==================
    Rule evaluations:	222
          Total time:	6.7778s
