================ SETTINGS ================
               files:	['./Data/Ragni/Class1/cv1_train_46.pl']
             verbose:	3
                   l:	None
                   p:	0.8
           beam_size:	100
                seed:	None
                 log:	./Logs/Ragni/Class1/cv1_rnvc46.log
              target:	rnvc46/2
   symmetry_breaking:	False
           probfoil1:	False
================= FINAL THEORY =================
rnvc46(A,B) :- somenot46(A,C), somenot46(B,C)
==================== SCORES ====================
            Accuracy:	 1.0
           Precision:	 1.0
              Recall:	 1.0
================== STATISTICS ==================
    Rule evaluations:	222
          Total time:	10.2487s
