================ SETTINGS ================
               files:	['./Data/Ragni/Class1/cv1_train_81.pl']
             verbose:	3
                   l:	None
                   p:	0.8
           beam_size:	100
                seed:	None
                 log:	./Logs/Ragni/Class1/cv1_rsome81.log
              target:	rsome81/2
   symmetry_breaking:	False
           probfoil1:	False
================= FINAL THEORY =================
rsome81(A,B) :- fail
==================== SCORES ====================
            Accuracy:	 0.825
           Precision:	 0.0
              Recall:	 0.0
================== STATISTICS ==================
    Rule evaluations:	10541
          Total time:	143.6630s
