================ SETTINGS ================
               files:	['./Data/Ragni/Class1/cv1_train_89.pl']
             verbose:	3
                   l:	None
                   p:	0.8
           beam_size:	100
                seed:	None
                 log:	./Logs/Ragni/Class1/cv1_rall89.log
              target:	rall89/2
   symmetry_breaking:	False
           probfoil1:	False
================= FINAL THEORY =================
rall89(A,B) :- no89(B,C), no89(C,A)
==================== SCORES ====================
            Accuracy:	 1.0
           Precision:	 1.0
              Recall:	 1.0
================== STATISTICS ==================
    Rule evaluations:	222
          Total time:	18.9313s
