================ SETTINGS ================
               files:	['./Data/Ragni/Class1/cv1_train_43.pl']
             verbose:	3
                   l:	None
                   p:	0.8
           beam_size:	100
                seed:	None
                 log:	./Logs/Ragni/Class1/cv1_rnvc43.log
              target:	rnvc43/2
   symmetry_breaking:	False
           probfoil1:	False
================= FINAL THEORY =================
rnvc43(A,B) :- some43(A,C), some43(B,C)
rnvc43(A,B) :- somenot43(B,C), somenot43(A,C)
==================== SCORES ====================
            Accuracy:	 1.0
           Precision:	 1.0
              Recall:	 1.0
================== STATISTICS ==================
    Rule evaluations:	530
          Total time:	12.9565s
