================ SETTINGS ================
               files:	['./Data/Ragni/Class5/cv5_train_7.pl']
             verbose:	3
                   l:	None
                   p:	0.8
           beam_size:	100
                seed:	None
                 log:	./Logs/Ragni/Class5/cv5_rnvc7.log
              target:	rnvc7/2
   symmetry_breaking:	False
           probfoil1:	False
================= FINAL THEORY =================
rnvc7(A,B) :- some7(B,C), \+all7(A,C), \+all7(C,A), \+no7(A,C), \+no7(C,A), \+somenot7(A,C), \+somenot7(C,A)
rnvc7(A,B) :- all7(A,C), some7(C,B)
==================== SCORES ====================
            Accuracy:	 1.0
           Precision:	 1.0
              Recall:	 1.0
================== STATISTICS ==================
    Rule evaluations:	2528
          Total time:	65.8813s
