================ SETTINGS ================
               files:	['./Data/Ragni/Class5/cv5_train_9.pl']
             verbose:	3
                   l:	None
                   p:	0.8
           beam_size:	100
                seed:	None
                 log:	./Logs/Ragni/Class5/cv5_rnvc9.log
              target:	rnvc9/2
   symmetry_breaking:	False
           probfoil1:	False
================= FINAL THEORY =================
rnvc9(A,B) :- some9(A,C), some9(C,B)
==================== SCORES ====================
            Accuracy:	 1.0
           Precision:	 1.0
              Recall:	 1.0
================== STATISTICS ==================
    Rule evaluations:	222
          Total time:	10.8451s
