================ SETTINGS ================
               files:	['./Data/Ragni/Class5/cv5_train_59.pl']
             verbose:	3
                   l:	None
                   p:	0.8
           beam_size:	100
                seed:	None
                 log:	./Logs/Ragni/Class5/cv5_rno59.log
              target:	rno59/2
   symmetry_breaking:	False
           probfoil1:	False
================= FINAL THEORY =================
rno59(A,B) :- some59(C,A), all59(C,B)
==================== SCORES ====================
            Accuracy:	 1.0
           Precision:	 1.0
              Recall:	 1.0
================== STATISTICS ==================
    Rule evaluations:	222
          Total time:	15.0034s
