================ SETTINGS ================
               files:	['./Data/Ragni/Class8/cv8_train_3.pl']
             verbose:	3
                   l:	None
                   p:	0.8
           beam_size:	100
                seed:	None
                 log:	./Logs/Ragni/Class8/cv8_rall3.log
              target:	rall3/2
   symmetry_breaking:	False
           probfoil1:	False
================= FINAL THEORY =================
rall3(A,B) :- somenot3(B,C), all3(A,C)
==================== SCORES ====================
            Accuracy:	 0.925
           Precision:	 1.0
              Recall:	 0.1
================== STATISTICS ==================
    Rule evaluations:	29090
          Total time:	961.0725s
