================ SETTINGS ================
               files:	['./Data/Ragni/Class4/cv4_train_36.pl']
             verbose:	3
                   l:	None
                   p:	0.8
           beam_size:	100
                seed:	None
                 log:	./Logs/Ragni/Class4/cv4_rnvc36.log
              target:	rnvc36/2
   symmetry_breaking:	False
           probfoil1:	False
================= FINAL THEORY =================
rnvc36(A,B) :- no36(B,C), no36(C,A)
==================== SCORES ====================
            Accuracy:	 1.0
           Precision:	 1.0
              Recall:	 1.0
================== STATISTICS ==================
    Rule evaluations:	222
          Total time:	6.6130s
