================ SETTINGS ================
               files:	['./Data/Ragni/Class4/cv4_train_81.pl']
             verbose:	3
                   l:	None
                   p:	0.8
           beam_size:	100
                seed:	None
                 log:	./Logs/Ragni/Class4/cv4_rnvc81.log
              target:	rnvc81/2
   symmetry_breaking:	False
           probfoil1:	False
================= FINAL THEORY =================
rnvc81(A,B) :- some81(A,C), somenot81(B,C)
==================== SCORES ====================
            Accuracy:	 1.0
           Precision:	 1.0
              Recall:	 1.0
================== STATISTICS ==================
    Rule evaluations:	222
          Total time:	12.8013s
