================ SETTINGS ================
               files:	['./Data/Ragni/Class4/cv4_train_87.pl']
             verbose:	3
                   l:	None
                   p:	0.8
           beam_size:	100
                seed:	None
                 log:	./Logs/Ragni/Class4/cv4_rall87.log
              target:	rall87/2
   symmetry_breaking:	False
           probfoil1:	False
================= FINAL THEORY =================
rall87(A,B) :- all87(B,C), no87(A,C)
==================== SCORES ====================
            Accuracy:	 1.0
           Precision:	 1.0
              Recall:	 1.0
================== STATISTICS ==================
    Rule evaluations:	222
          Total time:	33.5553s
