================ SETTINGS ================
               files:	['./Data/Ragni/Class4/cv4_train_44.pl']
             verbose:	3
                   l:	None
                   p:	0.8
           beam_size:	100
                seed:	None
                 log:	./Logs/Ragni/Class4/cv4_rno44.log
              target:	rno44/2
   symmetry_breaking:	False
           probfoil1:	False
================= FINAL THEORY =================
rno44(A,B) :- all44(B,C), no44(A,C)
==================== SCORES ====================
            Accuracy:	 1.0
           Precision:	 1.0
              Recall:	 1.0
================== STATISTICS ==================
    Rule evaluations:	222
          Total time:	15.4162s
