================ SETTINGS ================
               files:	['./Data/Ragni/Class4/cv4_train_62.pl']
             verbose:	3
                   l:	None
                   p:	0.8
           beam_size:	100
                seed:	None
                 log:	./Logs/Ragni/Class4/cv4_rsomenot62.log
              target:	rsomenot62/2
   symmetry_breaking:	False
           probfoil1:	False
================= FINAL THEORY =================
rsomenot62(A,B) :- all62(C,A), some62(B,C)
==================== SCORES ====================
            Accuracy:	 1.0
           Precision:	 1.0
              Recall:	 1.0
================== STATISTICS ==================
    Rule evaluations:	222
          Total time:	18.7538s
