================ SETTINGS ================
               files:	['./Data/Ragni/Class9/cv9_train_6.pl']
             verbose:	3
                   l:	None
                   p:	0.8
           beam_size:	100
                seed:	None
                 log:	./Logs/Ragni/Class9/cv9_rno6.log
              target:	rno6/2
   symmetry_breaking:	False
           probfoil1:	False
================= FINAL THEORY =================
rno6(A,B) :- all6(C,B), no6(A,C)
==================== SCORES ====================
            Accuracy:	 1.0
           Precision:	 1.0
              Recall:	 1.0
================== STATISTICS ==================
    Rule evaluations:	222
          Total time:	37.4784s
