================ SETTINGS ================
               files:	['./Data/Ragni/Class9/cv9_train_94.pl']
             verbose:	3
                   l:	None
                   p:	0.8
           beam_size:	100
                seed:	None
                 log:	./Logs/Ragni/Class9/cv9_rsomenot94.log
              target:	rsomenot94/2
   symmetry_breaking:	False
           probfoil1:	False
================= FINAL THEORY =================
rsomenot94(A,B) :- fail
==================== SCORES ====================
            Accuracy:	 0.825
           Precision:	 0.0
              Recall:	 0.0
================== STATISTICS ==================
    Rule evaluations:	10578
          Total time:	101.9186s
