================ SETTINGS ================
               files:	['./Data/Ragni/Class9/cv9_train_5.pl']
             verbose:	3
                   l:	None
                   p:	0.8
           beam_size:	100
                seed:	None
                 log:	./Logs/Ragni/Class9/cv9_rall5.log
              target:	rall5/2
   symmetry_breaking:	False
           probfoil1:	False
================= FINAL THEORY =================
rall5(A,B) :- all5(A,C), no5(B,C)
==================== SCORES ====================
            Accuracy:	 1.0
           Precision:	 1.0
              Recall:	 1.0
================== STATISTICS ==================
    Rule evaluations:	222
          Total time:	23.4702s
