================ SETTINGS ================
               files:	['./Data/Ragni/Class9/cv9_train_79.pl']
             verbose:	3
                   l:	None
                   p:	0.8
           beam_size:	100
                seed:	None
                 log:	./Logs/Ragni/Class9/cv9_rnvc79.log
              target:	rnvc79/2
   symmetry_breaking:	False
           probfoil1:	False
================= FINAL THEORY =================
rnvc79(A,B) :- some79(A,C), somenot79(B,C)
==================== SCORES ====================
            Accuracy:	 1.0
           Precision:	 1.0
              Recall:	 1.0
================== STATISTICS ==================
    Rule evaluations:	222
          Total time:	6.3426s
