================ SETTINGS ================
               files:	['./Data/Ragni/Class7/cv7_train_2.pl']
             verbose:	3
                   l:	None
                   p:	0.8
           beam_size:	100
                seed:	None
                 log:	./Logs/Ragni/Class7/cv7_rall2.log
              target:	rall2/2
   symmetry_breaking:	False
           probfoil1:	False
================= FINAL THEORY =================
rall2(A,B) :- all2(C,A), no2(C,B)
==================== SCORES ====================
            Accuracy:	 0.875
           Precision:	 1.0
              Recall:	 0.0625
================== STATISTICS ==================
    Rule evaluations:	64801
          Total time:	931.0765s
